X,X,X,X,X,X,X,X
X,O,O,O,O,O,O,X
X,O,X,O,X,X,O,X
X,X,X,X,O,O,X,X
X,O,O,O,X,X,X,X
X,O,X,O,0,O,X,X
X,0,X,X,X,X,X,O
X,O,0,O,O,0,O,X
X,X,X,X,X,X,X,X